date,very negative,negative,neutral or mixed,positive,very positive,total
2020-01-27,21,337,63,71,1,493
2020-01-28,665,8899,2034,2059,43,13700
2020-01-29,723,8749,2204,2261,38,13975
2020-01-30,762,9986,2150,2506,49,15453
2020-01-31,567,8675,1989,2278,45,13554
2020-02-01,465,6426,1497,1716,32,10136
2020-02-02,410,5841,1415,1700,36,9402
2020-02-03,423,5314,1391,1519,46,8693
2020-02-04,270,4007,1000,1153,29,6459
2020-02-05,124,2850,819,915,17,4725
2020-02-06,413,5758,1177,1322,33,8703
2020-02-07,387,5583,1191,1546,47,8754
2020-02-08,298,4978,996,1116,35,7423
2020-02-09,232,3979,816,878,19,5924
2020-02-10,317,4678,1115,1218,32,7360
2020-02-11,302,5255,1667,1656,26,8906
2020-02-12,251,4650,1364,1582,40,7887
2020-02-13,230,4778,1298,1524,39,7869
2020-02-14,206,3923,1059,1336,43,6567
2020-02-15,151,3211,858,1078,17,5315
2020-02-16,149,3363,1088,1252,19,5871
2020-02-17,201,4135,1121,1402,23,6882
2020-02-18,218,4681,1170,1380,26,7475
2020-02-19,181,3710,1076,1310,31,6308
2020-02-20,207,3555,962,1192,31,5947
2020-02-21,237,4168,1083,1257,27,6772
2020-02-22,222,3968,999,1113,23,6325
2020-02-23,318,5192,1302,1497,28,8337
2020-02-24,560,8459,1939,2194,31,13183
2020-02-25,992,14273,2957,3306,44,21572
2020-02-26,1399,19312,4029,4392,75,29207
2020-02-27,1833,25170,5055,5768,85,37911
2020-02-28,2222,29676,6541,7738,164,46341
2020-02-29,1620,22535,4641,5114,97,34007
2020-03-01,1286,17904,4097,4970,86,28343
2020-03-02,2020,26080,5817,7107,128,41152
2020-03-03,2396,28564,6698,7970,145,45773
2020-03-04,2467,28016,6618,8177,143,45421
2020-03-05,2715,31530,7731,9811,210,51997
2020-03-06,3142,35443,8798,11406,203,58992
2020-03-07,2587,28992,6724,8597,154,47054
2020-03-08,2744,30995,6587,8188,145,48659
2020-03-09,5688,62103,13058,15725,265,96839
2020-03-10,6251,67113,15872,19895,324,109455
2020-03-11,13193,121525,29859,36768,586,201931
2020-03-12,15710,161332,43396,56593,1020,278051
2020-03-13,13512,151656,42716,60860,1303,270047
2020-03-14,7447,91802,26410,38171,896,164726
2020-03-15,8199,97410,28386,41619,959,176573
2020-03-16,11618,128646,40289,58627,1122,240302
2020-03-17,7144,89363,28171,42668,865,168211
2020-03-18,10945,131773,41433,61890,1291,247332
2020-03-19,9109,111279,36200,54224,1192,212004
2020-03-20,7157,76540,22946,35109,1088,142840
2020-03-21,7042,94713,30836,47319,1396,181306
2020-03-22,7311,89376,26844,41009,1108,165648
2020-03-23,7107,99404,33376,52903,1255,194045
2020-03-24,7565,109308,36950,59348,1321,214492
2020-03-25,7213,106412,37192,61380,1410,213607
2020-03-26,7817,110987,37360,63115,2067,221346
2020-03-27,7148,100174,34921,58644,1511,202398
2020-03-28,6827,88416,26931,43371,1340,166885
2020-03-29,7800,91827,26055,41691,1274,168647
2020-03-30,7843,105460,35453,61408,1876,212040
2020-03-31,7612,104836,34646,59654,1554,208302
2020-04-01,7838,108553,35569,58818,1442,212220
2020-04-02,7779,102718,34249,56466,1624,202836
2020-04-03,7637,101867,34390,57024,1539,202457
2020-04-04,5934,76212,22468,35012,1003,140629
2020-04-05,6677,85288,24861,38388,1062,156276
2020-04-06,6983,101821,35317,59330,1555,205006
2020-04-07,7281,100944,33119,58507,1718,201569
2020-04-08,7190,98080,32228,54201,1479,193178
2020-04-09,6315,92596,31222,54416,1557,186106
2020-04-10,5984,84013,28406,48642,1781,168826
2020-04-11,5177,68028,19381,31750,1067,125403
2020-04-12,4293,59059,17338,27045,1209,108944
2020-04-13,5916,85463,29225,48510,1383,170497
2020-04-14,5457,84790,28703,49282,1413,169645
2020-04-15,6247,92182,31063,51059,1499,182050
2020-04-16,5941,90515,30626,52484,1551,181117
2020-04-17,6571,93902,30560,52456,1721,185210
2020-04-18,5185,71114,21729,34616,1299,133943
2020-04-19,4325,60966,17731,27221,795,111038
2020-04-20,5597,80392,26809,45388,1286,159472
2020-04-21,5227,81509,27224,46210,1310,161480
2020-04-22,5279,85041,28323,49223,1595,169461
2020-04-23,5639,85230,29140,49657,1659,171325
2020-04-24,4939,81757,28299,47921,1685,164601
2020-04-25,4039,57945,18032,27796,1071,108883
2020-04-26,4029,55639,17238,26194,875,103975
2020-04-27,5375,77567,26426,43797,1197,154362
2020-04-28,5188,80053,26009,44406,1351,157007
2020-04-29,5578,78963,25808,45999,1394,157742
2020-04-30,5428,77955,25338,45725,1504,155950
2020-05-01,4966,72918,24365,44692,1763,148704
2020-05-02,4216,56017,15817,25855,924,102829
2020-05-03,4390,55832,16025,23589,762,100598
2020-05-04,4939,71723,22712,39769,1318,140461
2020-05-05,5366,78682,24785,47541,1899,158273
2020-05-06,5337,77187,23829,41978,1918,150249
2020-05-07,4736,72772,23934,40499,1389,143330
2020-05-08,4687,69018,22963,39569,1425,137662
2020-05-09,4027,54264,15972,23616,853,98732
2020-05-10,3976,50016,13042,19771,889,87694
2020-05-11,4996,72287,22556,37182,1059,138080
2020-05-12,5209,74796,23370,40153,1202,144730
2020-05-13,4760,73452,23285,39783,1113,142393
2020-05-14,4732,74090,23287,40576,1172,143857
2020-05-15,3249,47033,15252,26705,798,93037
2020-05-16,3085,47728,14804,23074,734,89425
2020-05-17,3390,48902,14713,21984,636,89625
2020-05-18,4548,68731,22062,37241,1058,133640
2020-05-19,4338,71179,23229,38821,1134,138701
2020-05-20,4499,70639,22277,39686,1271,138372
2020-05-21,4574,69244,22473,38462,1298,136051
2020-05-22,4017,59824,19713,34509,1035,119098
2020-05-23,3292,46000,13041,20148,615,83096
2020-05-24,4166,51281,14030,20434,656,90567
2020-05-25,3769,49900,13830,21741,648,89888
2020-05-26,4375,62156,19915,33493,971,120910
2020-05-27,4533,62584,18913,32149,989,119168
2020-05-28,4289,61735,19276,32590,904,118794
2020-05-29,4462,56520,17777,29961,759,109479
2020-05-30,5104,47901,10955,15830,468,80258
2020-05-31,4851,47194,10291,13755,334,76425
2020-06-01,4808,53870,14334,22786,549,96347
2020-06-02,4485,50140,13225,20022,428,88300
2020-06-03,4432,54126,15024,24350,562,98494
2020-06-04,4110,51762,14651,23338,594,94455
2020-06-05,3486,47701,13998,22090,616,87891
2020-06-06,3224,38477,10128,14537,440,66806
2020-06-07,2493,31635,8578,12616,360,55682
2020-06-08,1989,27397,8529,13384,346,51645
2020-06-09,3222,46647,15014,24505,653,90041
2020-06-10,3341,48665,15789,25954,684,94433
2020-06-11,3499,51052,16397,27036,769,98753
2020-06-12,3338,48434,15444,25307,667,93190
2020-06-13,2697,34651,9751,14579,422,62100
2020-06-14,2792,34451,9462,14509,402,61616
2020-06-15,4200,57968,17749,26743,607,107267
2020-06-16,4246,59458,18175,29777,754,112410
2020-06-17,4082,56956,17714,28758,756,108266
2020-06-18,4114,56931,17902,29018,766,108731
2020-06-19,4261,56584,17394,26886,756,105881
2020-06-20,4651,58413,16529,23607,583,103783
2020-06-21,3131,40778,10686,15460,458,70513
2020-06-22,4325,60759,18305,28402,610,112401
2020-06-23,5432,69890,20914,32044,825,129105
2020-06-24,5946,71797,21131,32040,809,131723
2020-06-25,6214,78218,22116,33138,797,140483
2020-06-26,7048,85895,23164,33577,837,150521
2020-06-27,4775,59210,14730,20353,616,99684
2020-06-28,4514,54933,14171,19356,552,93526
2020-06-29,5437,69117,20656,29996,743,125949
2020-06-30,5723,73296,21130,31482,807,132438
2020-07-01,5892,75010,21741,32803,875,136321
2020-07-02,6638,81176,24231,35539,851,148435
2020-07-03,4990,63664,18919,28763,833,117169
2020-07-04,4198,48112,13500,20659,845,87314
2020-07-05,5093,54599,14152,18090,461,92395
2020-07-06,7430,82592,21973,31790,683,144468
2020-07-07,6740,82067,22832,33292,757,145688
2020-07-08,7639,86270,22642,33012,891,150454
2020-07-09,7601,78985,20985,31746,1018,140335
2020-07-10,7344,79102,20378,31160,922,138906
2020-07-11,6294,63494,15026,21762,717,107293
2020-07-12,6499,66685,15898,22950,718,112750
2020-07-13,9174,96875,24021,35142,914,166126
2020-07-14,8231,91711,23673,35731,935,160281
2020-07-15,7935,88600,22627,34835,959,154956
2020-07-16,8162,92589,23831,33625,986,159193
2020-07-17,7190,82336,20920,30948,966,142360
2020-07-18,5526,55430,13173,19536,582,94247
2020-07-19,5353,57350,13584,19867,521,96675
2020-07-20,6638,72978,19614,31174,820,131224
2020-07-21,5988,70578,19159,29352,890,125967
2020-07-22,5790,70114,19170,29980,864,125918
2020-07-23,6131,71390,19340,30445,918,128224
2020-07-24,5469,63416,17159,27183,878,114105
2020-07-25,4210,46720,11482,16858,572,79842
2020-07-26,4197,44815,11061,16135,505,76713
2020-07-27,6809,81134,22448,33007,898,144296
2020-07-28,6551,85276,23396,32622,843,148688
2020-07-29,6516,82522,23292,33063,945,146338
2020-07-30,9631,96712,22398,31505,1053,161299
2020-07-31,6599,74029,18740,28340,966,128674
2020-08-01,4840,54495,13358,18265,667,91625
2020-08-02,4988,53426,12906,18295,625,90240
2020-08-03,6082,69689,18709,28473,859,123812
2020-08-04,5972,67573,17989,26910,834,119278
2020-08-05,5535,67457,17922,27660,864,119438
2020-08-06,5646,68586,18735,29209,865,123041
2020-08-07,5473,64401,17375,26292,853,114394
2020-08-08,4130,48608,11908,17460,574,82680
2020-08-09,4475,52836,12782,18368,605,89066
2020-08-10,5922,68717,17862,27804,825,121130
2020-08-11,5598,67423,18406,27994,850,120271
2020-08-12,5022,61295,16886,26669,867,110739
2020-08-13,5449,63996,16823,26664,867,113799
2020-08-14,4737,56595,15729,25355,854,103270
2020-08-15,4049,44371,11330,16508,558,76816
2020-08-16,4110,44143,10871,15187,476,74787
2020-08-17,4671,58391,16731,25867,891,106551
2020-08-18,4897,58415,16233,25562,803,105910
2020-08-19,4916,58529,16436,26425,913,107219
2020-08-20,4398,53713,15517,24798,836,99262
2020-08-21,4481,49712,14126,22426,823,91568
2020-08-22,3712,40952,10497,14631,454,70246
2020-08-23,4466,49948,12318,16490,550,83772
2020-08-24,4493,54386,15667,24183,773,99502
2020-08-25,5053,52592,15425,24261,785,98116
2020-08-26,4943,55611,15107,23279,776,99716
2020-08-27,4883,58977,16006,24845,769,105480
2020-08-28,4545,52757,14632,22920,777,95631
2020-08-29,4018,42966,10249,14431,556,72220
2020-08-30,4573,53107,10150,13869,471,82170
2020-08-31,5719,69126,15294,22991,718,113848
2020-09-01,4963,61490,15687,23736,862,106738
2020-09-02,4606,56781,14759,21461,661,98268
2020-09-03,5836,66384,17343,27478,812,117853
2020-09-04,4032,49875,13728,22201,836,90672
2020-09-05,3151,36125,9377,14016,520,63189
2020-09-06,3031,35300,8505,12370,445,59651
2020-09-07,3276,39531,9778,15197,744,68526
2020-09-08,4362,54391,15344,22885,686,97668
2020-09-09,6385,79103,19079,25550,673,130790
2020-09-10,6658,80087,18902,26570,776,132993
2020-09-11,5257,60199,15005,22213,618,103292
2020-09-12,3971,47016,11693,16352,500,79532
2020-09-13,4270,47118,10715,14801,510,77414
2020-09-14,4584,57579,15331,23461,839,101794
2020-09-15,4418,57094,16673,25167,705,104057
2020-09-16,4716,63898,19159,27473,728,115974
2020-09-17,4873,62907,17357,26006,705,111848
2020-09-18,4151,54449,15124,22174,715,96613
2020-09-19,2681,30274,8002,11879,439,53275
2020-09-20,2898,33478,8437,12900,436,58149
2020-09-21,4448,54925,14765,21904,620,96662
2020-09-22,5228,65556,17018,24239,704,112745
2020-09-23,4210,53352,15291,23821,721,97395
2020-09-24,3638,49273,14850,23167,655,91583
2020-09-25,3557,46537,13879,22522,734,87229
2020-09-26,3157,38097,10092,14495,462,66303
2020-09-27,2679,32567,8679,12295,340,56560
2020-09-28,3340,43279,13187,19881,560,80247
2020-09-29,5327,65167,17716,25682,638,114530
2020-09-30,3408,44967,13663,22175,691,84904
2020-10-01,5753,92440,30132,47135,1189,176649
2020-10-02,9964,162162,46272,63260,1301,282959
2020-10-03,6886,100216,27653,34872,663,170290
2020-10-04,9558,115532,28034,33197,708,187029
2020-10-05,14757,176416,45509,56736,982,294400
2020-10-06,9384,136863,37365,45241,796,229649
2020-10-07,7746,128506,37300,45777,800,220129
2020-10-08,5018,89859,27592,34726,607,157802
2020-10-09,4857,76823,23480,32180,722,138062
2020-10-10,3846,55551,16034,22741,536,98708
2020-10-11,3630,51579,14800,20152,518,90679
2020-10-12,4764,69503,20726,28785,643,124421
2020-10-13,4140,60890,19809,29813,629,115281
2020-10-14,4273,60037,19622,29008,734,113674
2020-10-15,3331,54866,18003,27044,597,103841
2020-10-16,3296,52918,17581,26274,656,100725
2020-10-17,2969,41164,12871,18325,450,75779
2020-10-18,2934,40196,11788,16398,483,71799
2020-10-19,4285,55790,16789,24746,882,102492
2020-10-20,3805,55739,16465,24937,656,101602
2020-10-21,3704,56138,16940,25367,672,102821
2020-10-22,4878,67928,19566,28861,691,121924
2020-10-23,3816,50767,15061,22825,627,93096
2020-10-24,4055,50413,13949,18699,531,87647
2020-10-25,4227,53439,14347,18033,393,90439
2020-10-26,4794,68635,20626,28138,570,122763
2020-10-27,5577,72711,22444,32236,746,133714
2020-10-28,5672,70749,20737,30650,821,128629
2020-10-29,4886,64898,19369,29317,771,119241
2020-10-30,5355,71768,19393,28935,760,126211
2020-10-31,4836,57806,15666,22728,787,101823
2020-11-01,4101,52992,13586,18131,473,89283
2020-11-02,4485,59289,16756,24232,607,105369
2020-11-03,3771,47977,14404,21042,495,87689
2020-11-04,3931,52748,15544,21214,471,93908
2020-11-05,4230,60822,18121,24589,515,108277
2020-11-06,4768,64049,18241,24976,701,112735
2020-11-07,5005,71981,22050,31350,1132,131518
2020-11-08,3296,45903,13776,18481,465,81921
2020-11-09,4789,70994,23957,41919,1410,143069
2020-11-10,4611,60269,19182,29803,796,114661
2020-11-11,5688,67132,20694,29687,735,123936
2020-11-12,7177,86902,26177,36966,841,158063
2020-11-13,6789,83759,24659,33985,852,150044
2020-11-14,5700,61394,17565,23744,619,109022
2020-11-15,5735,61456,16668,22134,574,106567
2020-11-16,7511,82114,23568,37088,988,151269
2020-11-17,7022,82975,25312,40162,1351,156822
2020-11-18,7906,90482,26100,40866,1139,166493
2020-11-19,7459,85815,25339,37056,1032,156701
2020-11-20,6243,81154,25998,40234,1110,154739
2020-11-21,5022,60449,17822,25753,745,109791
2020-11-22,5200,55546,15894,23404,755,100799
2020-11-23,5505,65108,21475,35815,1025,128928
2020-11-24,4868,63863,20613,32871,992,123207
2020-11-25,5420,65886,20347,32563,1394,125610
2020-11-26,3690,43712,13830,25000,2783,89015
2020-11-27,3436,44609,13891,20624,640,83200
2020-11-28,3724,43728,12846,18489,498,79285
2020-11-29,3922,45898,13102,19112,567,82601
2020-11-30,4103,53012,16840,25551,642,100148
2020-12-01,4449,59004,19713,33013,940,117119
2020-12-02,4690,61037,20296,33629,697,120349
2020-12-03,5577,70627,22731,34731,796,134462
2020-12-04,5825,70082,21225,33546,955,131633
2020-12-05,5071,54831,15461,22595,573,98531
2020-12-06,5007,61781,18502,25381,566,111237
2020-12-07,5847,74410,22899,33422,841,137419
2020-12-08,6171,79945,25560,41029,945,153650
2020-12-09,5479,70350,21979,34196,814,132818
2020-12-10,5727,71901,23119,37057,931,138735
2020-12-11,5304,67821,22483,34769,864,131241
2020-12-12,4474,49758,15700,26369,719,97020
2020-12-13,4085,47100,14201,22244,649,88279
2020-12-14,4403,59886,20756,38885,1273,125203
2020-12-15,4788,61185,20427,37113,1231,124744
2020-12-16,5259,67765,22376,36705,1201,133306
2020-12-17,5261,66945,21898,37341,1293,132738
2020-12-18,5467,69014,21944,37520,1276,135221
2020-12-19,5313,55791,15655,23599,963,101321
2020-12-20,4561,57030,17166,26081,727,105565
2020-12-21,5667,69189,22758,40114,1040,138768
2020-12-22,5076,73008,25514,41058,1210,145866
2020-12-23,4490,61847,21407,34891,1155,123790
2020-12-24,4017,45613,14114,25322,1414,90480
2020-12-25,2338,26864,8415,16017,1120,54754
2020-12-26,3761,39240,11023,16899,646,71569
2020-12-27,4601,48599,13922,21376,597,89095
2020-12-28,4140,55494,18477,29328,758,108197
2020-12-29,5470,67608,21455,32446,794,127773
2020-12-30,6512,75448,24138,35140,907,142145
2020-12-31,5189,63064,19872,34061,1909,124095
2021-01-01,3940,45527,13280,20798,1067,84612
2021-01-02,4032,47001,13316,18826,540,83715
2021-01-03,3904,47241,13196,18194,431,82966
2021-01-04,4449,55762,18153,27474,778,106616
2021-01-05,4891,60332,19689,29734,811,115457
2021-01-06,4387,52200,16774,25492,639,99492
2021-01-07,3301,41647,13198,21190,562,79898
2021-01-08,3661,44100,14432,24248,773,87214
2021-01-09,3099,31510,9603,14913,556,59681
2021-01-10,3187,33141,8968,14229,431,59956
2021-01-11,4035,45905,15458,26400,769,92567
2021-01-12,4447,52393,16575,28063,941,102419
2021-01-13,3741,43611,14797,25830,843,88822
2021-01-14,3289,40361,14160,26046,877,84733
2021-01-15,4051,47175,16626,27826,985,96663
2021-01-16,3064,33734,10527,17257,680,65262
2021-01-17,2841,31632,9321,14238,501,58533
2021-01-18,2860,32504,10500,16858,572,63294
2021-01-19,4040,48563,16588,29202,1128,99521
2021-01-20,3179,39020,13301,24228,1156,80884
2021-01-21,3739,48631,17094,27162,965,97591
2021-01-22,3642,46023,15911,25885,845,92306
2021-01-23,3099,34821,10700,17210,625,66455
2021-01-24,3140,35468,11433,18234,550,68825
2021-01-25,3899,48060,17362,28835,842,98998
2021-01-26,3819,46730,16592,27760,881,95782
2021-01-27,3451,44411,15495,25863,907,90127
2021-01-28,3188,43334,15380,25995,832,88729
2021-01-29,3304,42193,16136,26705,909,89247
2021-01-30,3025,33847,10822,16645,672,65011
2021-01-31,2771,33899,11274,16823,533,65300
2021-02-01,2968,40696,15218,25507,674,85063
2021-02-02,2898,40031,15415,26742,758,85844
2021-02-03,3124,41244,15669,26826,867,87730
2021-02-04,3054,40929,15067,25896,840,85786
2021-02-05,2816,38154,15070,27038,940,84018
2021-02-06,2483,29203,9256,15261,585,56788
2021-02-07,2633,32852,11014,18610,748,65857
2021-02-08,3271,42561,13915,23027,722,83496
2021-02-09,2786,38953,13757,22918,745,79159
2021-02-10,2819,38089,14183,24523,841,80455
2021-02-11,2931,40171,13703,24232,883,81920
2021-02-12,2634,35368,12474,21587,906,72969
2021-02-13,2353,27819,8372,13644,539,52727
2021-02-14,1792,23189,7155,12231,662,45029
2021-02-15,2403,33110,10490,17040,541,63584
2021-02-16,2996,38895,12885,21766,669,77211
2021-02-17,3052,38792,12980,21697,700,77221
2021-02-18,2951,38260,12400,21046,659,75316
2021-02-19,2443,34517,12154,21357,708,71179
2021-02-20,2031,25014,8102,13320,463,48930
2021-02-21,2192,27498,8421,12810,418,51339
2021-02-22,3102,41720,13756,23367,694,82639
2021-02-23,2891,37872,13147,23029,757,77696
2021-02-24,2764,36688,14768,27054,920,82194
2021-02-25,2698,37401,14176,26072,887,81234
2021-02-26,2378,35036,13559,26266,975,78214
2021-02-27,2225,29626,10227,20022,677,62777
2021-02-28,2112,26783,9218,15237,524,53874
2021-03-01,2368,35601,13939,24696,890,77494
2021-03-02,4914,57015,19524,31692,1054,114199
2021-03-03,3633,49858,17209,29148,1029,100877
2021-03-04,3230,47543,16206,28388,1006,96373
2021-03-05,2941,43533,15534,28433,999,91440
2021-03-06,2492,32219,11613,23655,833,70812
2021-03-07,2129,28204,9472,16672,508,56985
2021-03-08,2174,33522,13680,26133,987,76496
2021-03-09,2139,34840,13755,26821,945,78500
2021-03-10,2542,40059,16526,37650,1330,98107
2021-03-11,2920,44518,18116,37562,1374,104490
2021-03-12,2352,33699,13081,24910,1042,75084
2021-03-13,1748,25714,9023,16140,801,53426
2021-03-14,1820,26753,8824,15037,833,53267
2021-03-15,2191,35938,14008,24626,957,77720
2021-03-16,2406,34863,13616,25623,998,77506
2021-03-17,2716,35150,12737,23690,1037,75330
2021-03-18,2523,34372,12245,23134,1004,73278
2021-03-19,3052,34678,10786,21475,1232,71223
2021-03-20,2977,28551,7950,13976,905,54359
2021-03-21,2840,26542,7100,12590,649,49721
2021-03-22,3561,35061,11657,25344,1200,76823
2021-03-23,2944,31712,11294,21819,1093,68862
2021-03-24,2788,31440,11298,22497,1104,69127
2021-03-25,3622,34810,11315,22289,1249,73285
2021-03-26,3476,31689,10701,20758,1085,67709
2021-03-27,2590,21706,6603,12269,711,43879
2021-03-28,3095,24566,6847,12166,555,47229
2021-03-29,4803,41066,11400,24244,1001,82514
2021-03-30,4682,40741,11235,22624,1151,80433
2021-03-31,3882,37493,11103,24141,1251,77870
2021-04-01,3906,36100,11045,23335,1189,75575
2021-04-02,3283,29611,9290,20756,1039,63979
2021-04-03,2542,21799,6186,13942,641,45110
2021-04-04,2380,19818,5357,11882,593,40030
2021-04-05,4050,34627,10852,22893,946,73368
2021-04-06,4050,35604,11079,23902,1078,75713
2021-04-07,3924,35874,11030,22664,1055,74547
2021-04-08,3687,33493,9980,20028,974,68162
2021-04-09,3523,31308,9629,20432,1001,65893
2021-04-10,3103,24784,6679,13264,632,48462
2021-04-11,2901,23512,6396,12372,499,45680
2021-04-12,3586,31713,10251,20542,833,66925
2021-04-13,3868,38376,11598,20406,770,75018
2021-04-14,3474,32175,9434,19680,813,65576
2021-04-15,3850,34821,10969,20186,901,70727
2021-04-16,3557,29662,9109,19346,811,62485
2021-04-17,2607,21658,5701,14080,646,44692
2021-04-18,2932,23205,5923,14581,494,47135
2021-04-19,3413,30608,9377,22739,815,66952
2021-04-20,3268,29734,9159,21724,747,64632
2021-04-21,2979,27354,8654,20490,748,60225
2021-04-22,3326,30377,9218,18710,854,62485
2021-04-23,3339,30652,10332,23997,909,69229
2021-04-24,2997,23949,6296,17276,584,51102
2021-04-25,3278,26312,6839,18478,506,55413
2021-04-26,3949,33478,9840,24545,698,72510
2021-04-27,4937,40086,10713,25556,671,81963
2021-04-28,4135,35414,10199,23778,794,74320
2021-04-29,3187,29478,8935,20229,803,62632
2021-04-30,3286,29250,8816,21460,834,63646
2021-05-01,2579,21081,5937,16228,551,46376
2021-05-02,2321,19115,5368,15219,439,42462
2021-05-03,4036,35107,9694,23267,868,72972
2021-05-04,3782,32567,9956,23058,853,70216
2021-05-05,3588,30157,9580,23019,915,67259
2021-05-06,3154,29585,8995,20426,1249,63409
2021-05-07,3189,29536,8793,21077,882,63477
2021-05-08,2444,20418,5830,10822,538,40052
2021-05-09,2215,18365,4952,10016,578,36126
2021-05-10,3363,29075,9117,18975,698,61228
2021-05-11,3474,30690,9055,19512,741,63472
2021-05-12,3271,29147,9362,24143,952,66875
2021-05-13,4143,39414,11659,24959,847,81022
2021-05-14,3687,35903,9904,19417,749,69660
2021-05-15,2474,21857,5671,10038,478,40518
2021-05-16,2350,19730,5055,11239,393,38767
2021-05-17,2938,27501,8373,21723,644,61179
2021-05-18,3033,27451,7959,20710,649,59802
2021-05-19,2598,25197,7888,19079,629,55391
2021-05-20,2869,25580,7838,18208,692,55187
2021-05-21,2422,22846,7141,19257,699,52365
2021-05-22,2093,17714,4946,14767,449,39969
2021-05-23,2259,21194,5417,12810,366,42046
2021-05-24,2931,29282,7837,17509,499,58058
2021-05-25,2738,27145,7529,17789,537,55738
2021-05-26,3061,29804,7804,17562,572,58803
2021-05-27,3010,28997,7479,15547,596,55629
2021-05-28,2487,24248,7105,16002,569,50411
2021-05-29,2076,17894,5273,10503,370,36116
2021-05-30,1905,17696,4394,7254,311,31560
2021-05-31,1949,16661,4656,7550,290,31106
2021-06-01,2348,22512,6725,13023,533,45141
2021-06-02,2787,25767,7441,13282,557,49834
2021-06-03,2776,26928,7230,13306,571,50811
2021-06-04,2722,25196,6807,12291,533,47549
2021-06-05,2382,18943,4692,7874,368,34259
2021-06-06,2041,17710,4361,7117,332,31561
2021-06-07,2357,23374,6442,11803,444,44420
2021-06-08,2278,21395,6538,12178,489,42878
2021-06-09,2562,24787,6811,12863,486,47509
2021-06-10,2325,24364,6705,12632,526,46552
2021-06-11,2037,21229,6165,12193,601,42225
2021-06-12,1603,14775,3807,6433,314,26932
2021-06-13,1721,16239,3896,6492,296,28644
2021-06-14,2487,22704,6294,13262,468,45215
2021-06-15,2517,25960,7542,13539,573,50131
2021-06-16,2875,25809,7039,12156,454,48333
2021-06-17,2195,20981,6211,10821,527,40735
2021-06-18,2165,21037,5957,10865,487,40511
2021-06-19,1744,15717,3546,6290,317,27614
2021-06-20,1619,13965,3372,6035,298,25289
2021-06-21,2183,21339,5587,10557,477,40143
2021-06-22,2213,23354,6319,12089,385,44360
2021-06-23,2246,22889,6554,10998,391,43078
2021-06-24,2196,22560,6067,10232,482,41537
2021-06-25,2154,20989,5539,9547,415,38644
2021-06-26,2370,19045,4147,6200,291,32053
2021-06-27,2044,16499,3772,6160,240,28715
2021-06-28,2291,21508,5717,10127,372,40015
2021-06-29,2350,21833,5737,10968,360,41248
2021-06-30,2406,20728,5688,11398,425,40645
2021-07-01,1877,17786,5128,9784,401,34976
2021-07-02,1856,16385,4739,9262,422,32664
2021-07-03,1552,12733,3208,5621,251,23365
2021-07-04,1639,12395,3066,5514,390,23004
2021-07-05,2198,17898,4172,7535,237,32040
2021-07-06,2530,22486,5994,10583,378,41971
2021-07-07,2849,24133,6294,10283,338,43897
2021-07-08,3304,29487,7422,11478,371,52062
2021-07-09,2838,24759,6074,10033,397,44101
2021-07-10,2520,18605,4249,6626,261,32261
2021-07-11,3316,22464,4513,7321,239,37853
2021-07-12,3594,29322,7021,10949,373,51259
2021-07-13,3580,29191,7021,10902,385,51079
2021-07-14,4061,32205,7816,11732,435,56249
2021-07-15,4277,35866,8528,11912,415,60998
2021-07-16,5027,39669,8822,12355,435,66308
2021-07-17,4323,34325,7010,9782,266,55706
2021-07-18,3863,30179,6742,9189,274,50247
2021-07-19,5397,45764,10327,16113,371,77972
2021-07-20,6136,51151,11565,15969,370,85191
2021-07-21,6355,52116,10563,15388,368,84790
2021-07-22,7033,57649,11595,16006,391,92674
2021-07-23,6430,53898,10827,15604,483,87242
2021-07-24,4837,39877,7419,9978,314,62425
2021-07-25,4583,37016,7271,9436,235,58541
2021-07-26,5705,48372,12075,16568,434,83154
2021-07-27,6985,54145,12966,16351,387,90834
2021-07-28,7440,58560,13249,18015,459,97723
2021-07-29,8737,64668,14001,18892,444,106742
2021-07-30,9373,69280,14124,18749,463,111989
2021-07-31,7191,49810,9984,13634,367,80986
2021-08-01,6761,46574,9076,12960,337,75708
2021-08-02,8068,62057,14465,20176,476,105242
2021-08-03,8531,62694,14638,19559,435,105857
2021-08-04,10507,71844,16156,20537,505,119549
2021-08-05,9291,66505,15074,20389,537,111796
2021-08-06,8435,61559,13692,19678,492,103856
2021-08-07,7292,49967,9957,15484,348,83048
2021-08-08,7299,51065,9749,14754,370,83237
2021-08-09,9844,68535,14519,21589,457,114944
2021-08-10,10506,70340,14575,20311,539,116271
2021-08-11,10364,70709,15221,20641,548,117483
2021-08-12,9849,69316,15117,21805,567,116654
2021-08-13,8740,63504,13922,21213,557,107936
2021-08-14,6764,44983,8859,13528,379,74513
2021-08-15,5734,36836,7338,10995,306,61209
2021-08-16,6334,46468,11241,17574,456,82073
2021-08-17,7874,63710,16788,24482,543,113397
2021-08-18,8360,61715,15095,21475,490,107135
2021-08-19,8373,57177,13006,19471,560,98587
2021-08-20,8162,57651,12422,19467,509,98211
2021-08-21,7232,49149,10312,13770,375,80838
2021-08-22,6965,45953,8864,12725,326,74833
2021-08-23,8664,66963,14751,30171,765,121314
2021-08-24,8310,63959,14732,21303,497,108801
2021-08-25,8880,64432,14604,20817,503,109236
2021-08-26,8845,59148,12784,18520,530,99827
2021-08-27,8471,57282,12889,17489,524,96655
2021-08-28,6960,44992,9233,11886,375,73446
2021-08-29,6995,41672,8124,10452,290,67533
2021-08-30,7838,54305,12062,16732,455,91392
2021-08-31,7087,52121,11461,16946,441,88056
2021-09-01,5191,41164,9686,13263,348,69652
